111111111111111111
1P000000000M000001
100000M00000000001
10M0000000C0000001
111100000000000001
1000000000000M0001
1000M00000000000E1
111111111111111111