111111111111111111111111111111
1E0110010000000000000000000001
101000001000000000000000000001
100000011100000000011100000001
11000001C00000P00000C100000001
100000011100000000011100000001
100000000000000000000000000001
100000000000011100000000000001
100000000000111110000000000001
100000000000000000000000000001
100000010000000000000100000001
100000001111111111111000000001
100000000000011100000000000001
100000000000001000000000000001
100000000000000000000000000001
111111111111111111111111111111