111111111111
1E0000000001
10000000C001
100000P00001
100000000001
100C00000001
111111111111