111111111111111111111111111111
1E0000000000000000000000000001
100000000000000000000000000001
10000001110000P000011100000001
10000001C00000000000C100000001
100000011100000000011100000001
100000000000000000000000000001
100000000000011100000000000001
100000000000111110000000000001
100000000000000000000000000001
100000010000000000000100000001
100000001111111111111000000001
100000000000011100000000000001
100000000000001000000000000001
100000000000000000000000000001
111111111111111111111111111111