111111111111111111111111111111
1E1C0001C0000000000100000000C1
100101011110101010100110111011
10100101100000000000111C111001
10001001C00011111110C111111101
11111011111010C1C0111110000001
1C0000000000101110111111011111
111111111010101110110000010C01
1000100010C0100000110100000001
101010101111111011110111111111
1C1000100000000000000000000001
111111111111110111111111101111
1C110001000001C1000000000000C1
100101010101011111111110111111
1100010001000000000000000000P1
111111111111111111111111111111