111111111111111111111111111111
1E0000000000000000000000000001
10000000C000000000000000000001
100000000000000000000000000001
10000000P000000000000000000001
1000000000000000000C0000000001
100000000000000000000000000001
100000000000000000000000000001
100000000000000000000000000001
100000000000000001111100000001
100000000000000000010000000001
100000000000000000000000000001
100000000000000000000000000001
100000000000000000000000000001
100000000000000000000000000001
111111111111111111111111111111