111111111111111
1E00000P0000001
10000000C000001
100000000000001
100000000000001
100C00000000001
100000000000001
111111111111111