111111111111111111111
1P1E00000000000000001
10C000000000000000001
100000000000000000001
111111111111111111111
