111111111111111111111111111111
1E00100010P0000000000000000001
100000000000000000000000000001
100000000000000000000000000001
100000000000000000000000000001
100000000000000000000000000001
100000000000000000000000000001
100000000000000000000000000001
10000000C000000000000000000001
111111111111111111111111111111
100000000000000000000000000001
100000000000000000000000000001
1000000000H0000000000000000001
100000000000000000000000000001
100000000000000000000000000001
111111111111111111111111111111