111111111111111111111111111111
1ECP00000000000000000000000001
100000000000000000000000000001
100000000000000000000000000001
100000000000000000000000000001
100000000000000000000000000001
100000000000000000000000000001
100000000000000000000000000001
100000000000000000000000000001
111111111111111111111111111111
100000000000000000000000000001
100000000000000000000000000001
1000000000000C0000000000000001
100000000000000000000000000001
100000000000000000000000000001
111111111111111111111111111111