1111111111111
1P0C0000010C1
100100E100001
1111111111111