1111111111111
1P0C0E00010C1
1000000000001
1111111111111